VVGEGGGVVV
VVGPGGGGVV
VGGPPPPPGG
GGGGGGGPGG
GPPPGGGPGG
GPGPGGGPGG
GPGPPPPPGV
GSGGGGGGVV