VVGGGGEG
VGGPPPPG
GGGPGGGG
GGGPGGGG
GPPPGGGV
GSGGGGVV