FFGEGGGFFF
FFGPGGGGFF
FGGPPPPPGG
GGGGGGGPGG
GPPPGGGPGG
GPGPGGGPGG
GPGPPPPPGF
GSGGGGGGFF